BspWrd —— backspace entire word
CapsWd –– CAPS word
###### –– key held to activate layer
DTT    —— Dynamic Tap Term adjustments
HRM    —— Home Row Mods (tap/hold)

COLEMAK (tap)
,-----------------------------------------------------------------------------------.
|   `  |   1  |   2  |   3  |   4  |   5  |   6  |   7  |   8  |   9  |   0  |   -  |
|------+------+------+------+------+------+------+------+------+------+------+------|
|   ⇥  |   Q  |   W  |   F  |   P  |   B  |   J  |   L  |   U  |   Y  |   ;  |  Del | // PLANCK s/TAB/`/ 
|------+------+------+------+------+------+------+------+------+------+------+------|
|  Esc |   A  |   R  |   S  |   T  |   G  |   M  |   N  |   E  |   I  |   O  |   '  |
|------+------+------+------+------+------+------+------+------+------+------+------|
|   ⇧  |   Z  |   X  |   C  |   D  |   V  |   K  |   H  |   ,  |   .  |   /  |   ⏎  |
|------+------+------+------+------+------+------+------+------+------+------+------|
|   Fn |   ⌃  |   ⌥  |   ⇥  |   ␣  |   E  |      |   ⌫  | Enter|      |      |      |
`-----------------------------------------------------------------------------------'
COLEMAK (hold, Home Row Mods enabled):
,-----------------------------------------------------------------------------------.
|      |      |      |      |      |      |      |      |      |      |      |      |
|------+------+------+------+------+------+------+------+------+------+------+------|
|  ⌃⌥⇧ |      |      |      |      |      |      |      |      |      |      |  ⌃⌥⇧ |
|------+------+------+------+------+------+------+------+------+------+------+------|
|   ⌃  |   ⌃  |   ⌥  |   ⌘  |   ⇧  |      |      |   ⇧  |   ⌘  |   ⌥  |   ⌃  |   ⌥  |
|------+------+------+------+------+------+------+------+------+------+------+------| 
|   ⇧  |      |      |      |      |      |      |      |   ⌘  |   ⌥  |   ⌃  |   ⇧  |
|------+------+------+------+------+------+------+------+------+------+------+------|
|  Fn  |   ⌃  |   ⌥  |   ⌘  |  NUM |  FUN |  NAV |   ⇧  |  MED |      |      |      |
`-----------------------------------------------------------------------------------'

NUMBER
,-----------------------------------------------------------------------------------.
|      |      |      |      |      |      |      |      |      |      |      |      |
|------+------+------+------+------+------+------+------+------+------+------+------|
|   `  |   !  |   @  |   #  |   _  |   (  |   )  |   7  |   8  |   9  |   *  |   &  |
|------+------+------+------+------+------+------+------+------+------+------+------|
| Voice|   ⌃  |   ⌥  |   ⌘  |   ⇧  |   [  |   ]  |   4  |   5  |   6  |   0  |   +  |
|------+------+------+------+------+------+------+------+------+------+------+------|
|   >  |   \  |   [  |   ]  |   -  |   =  |   :  |   1  |   2  |   3  |   /  |   ⏎  | 
|------+------+------+------+------+------+------+------+------+------+------+------|
|      |      |      | Em — |######|   <  |   0  |   ⌫  |   .  |      |      |      |
`-----------------------------------------------------------------------------------'

FUNCTION  
,-----------------------------------------------------------------------------------.
|      |      |      |      |      |      |      |      |      |      |      |      |
|------+------+------+------+------+------+------+------+------+------+------+------|
|      |  F1  |  F2  |  F3  |  F4  |  F5  |  F6  |  F7  |  F8  |  F9  |  F10 |      |
|------+------+------+------+------+------+------+------+------+------+------+------|
|  FN  |  F11 |  F12 |  F13 |  F14 |  F15 |      |   ⇧  |   ⌘  |   ⌥  |   ⌃  |  FN  |
|------+------+------+------+------+------+------+------+------+------+------+------|
| Caps | Undo | Cut  | Copy | Paste| Paste|  F16 |  F17 |  F18 |  F19 |  F20 |      |
|------+------+------+------+------+------+------+------+------+------+------+------|
|      |      |      |  GAM |      |######|      |      |      |      |      |      |
`-----------------------------------------------------------------------------------'

NAV
,-----------------------------------------------------------------------------------.
|      |      |      |      |      |      |      |      |      |      |      |      |
|------+------+------+------+------+------+------+------+------+------+------+------|
| Tab  |      |      |      |      |      | mWhU | Home | PGDN | PGUP | End  | mWhU |
|------+------+------+------+------+------+------+------+------+------+------+------|
|      |   ⌃  |   ⌥  |   ⌘  |   ⇧  |      |  BS  | Left | Down |  Up  | Right|  Del |
|------+------+------+------+------+------+------+------+------+------+------+------|
| Caps | Undo | Cut  | Copy | Paste| Paste| mWhD | Back | Cmd -| Cmd =| Fwd  | mWhD |
|------+------+------+------+------+------+------+------+------+------+------+------|
|      |      |      |  Tab | Spc  |      |######|      |      |      |      |      |
`-----------------------------------------------------------------------------------'

MEDIA
,-----------------------------------------------------------------------------------.
|      |      |      |      |      |      |      |      |      |      |      |      |
|------+------+------+------+------+------+------+------+------+------+------+------|
|      |      |      |      | Play |      |      | Prev | VolDn| VolUp| Next |      |
|------+------+------+------+------+------+------+------+------+------+------+------|
|  Fn  | Prev | VolDn| VolUp| Next |      |      |   ⇧  |   ⌘  |   ⌥  |   ⌃  |  Fn  |
|------+------+------+------+------+------+------+------+------+------+------+------|
|      | REC 1| REC 2| PLY 2| PLY 1| STOP |      | Play |      |      |      |      |
|------+------+------+------+------+------+------+------+------+------+------+------|
|      |      |      |      |  PTR |      |      |      |######|      |      |      |
`-----------------------------------------------------------------------------------'

POINTER
,-----------------------------------------------------------------------------------.
|      |      |      |      |      |      |      |      |      |      |      |      |
|------+------+------+------+------+------+------+------+------+------+------+------|
|      |      |      |      |      |      |      |  whL |  whD |  whU |  whR | EXIT |
|------+------+------+------+------+------+------+------+------+------+------+------|
|      |   ⌃  |   ⌥  |   ⌘  |   ⇧  |      |  b1  |  msL |  msD |  msU |  msR |  b2  | 
|------+------+------+------+------+------+------+------+------+------+------+------|
|      | Undo | Cut  | Copy | Paste| Paste|      |  b1  |  b2  |  b3  |      |      |
|------+------+------+------+------+------+------+------+------+------+------+------|
|      |      |      |      |######|      |  b2  |  b1  |######|      |      |      |
`-----------------------------------------------------------------------------------'
  
QWERTY
,-----------------------------------------------------------------------------------.
| Esc  |   1  |   2  |   3  |   4  |   5  |   6  |   7  |   8  |   9  |   0  | Bspc |
|------+------+------+------+------+------+------+------+------+------+------+------|
| Tab  |   Q  |   W  |   E  |   R  |   T  |   Y  |   U  |   I  |   O  |   P  |  DEL |
|------+------+------+------+------+------+------+------+------+------+------+------|
| Esc  |   A  |   S  |   D  |   F  |   G  |   H  |   J  |   K  |   L  |   ;  |   '  |
|------+------+------+------+------+------+------+------+------+------+------+------|
| Shift|   Z  |   X  |   C  |   V  |   B  |   N  |   M  |   ,  |   .  |   /  |Enter |
|------+------+------+------+------+------+------+------+------+------+------+------|
| EXIT | Ctrl | Gui  | Alt  |  Spc | Ctrl | EXIT | Bspc | Left | Down |  Up  |Right |
`-----------------------------------------------------------------------------------'

COMBOS:

wf ➡️ (
fp ➡️ )
xc ➡️ [
cd ➡️ ]

nu ➡️ PTR LOCK
ar ➡️ CAPS WORD
rs ➡️ CMD

ne ➡️ BACKSPACE WORD
uy ➡️ HOME ROW MODIFIERS OFF
ei ➡️ CMD
,. ➡️ HOME ROW MODIFIERS ON
io ➡️ DELETE WORD

esc del ➡️ RESET

